##########
#+########
##+#######
###+######
###+++####
#####+####
#*####+###
#*#####+##
########+#
##########
