##########
#+########
##+#######
###+######
####+#####
#####+####
######+###
######+###
########+#
##########