######%#^%
####+#%#^%
##++##%#^%
##++##%#^%
##++##%#^%
##++##%#^%
##++##%#^%
##++##%#^%
##++##%#^%
##++##%#^%
