##__###^%#
##__##+^%#
##__##+^%#
##__##+^%#
##__##+^%#
##__##+^%#
##__##+^%#
##__##+^%#
##__##+^%#
##*_##+^%#
